401290075
200300800
070080006
000103062
105000403
730608000
600020030
007001004
890065107